title(TeamPenetrodeIsInDaHizouse)
version(0.00000718234)
author(3R1C H@@53)
20 15
*  *  *  *  *  *  *  *  *  *  *  *  *  *  *  *  *  *  *  *
*  P3 P1 P4 D  .  P2 .  D  .  .  .  .  .  .  D  .  .  .  *
*  .  .  .  D  .  !0 .  D  .  .  .  !3 .  .  D  .  .  !2 *
*  .  .  .  *  *  *  *  *  .  .  *  *  *  *  *  .  .  .  *
*  .  !0 .  *  .  .  .  *  .  .  !0 .  *  .  .  .  .  .  *
*  .  .  .  *  .  .  .  *  .  .  .  .  *  .  .  .  .  .  *
*  .  .  .  *  .  .  .  *  .  .  .  .  *  .  .  .  .  .  *
*  .  .  .  *  *  *  *  *  !1 .  .  .  *  .  .  .  .  .  *
*  .  .  .  *  !0 .  .  .  .  M1 .  .  *  .  .  .  .  .  *
*  .  .  .  *  .  G0 .  .  .  .  .  .  *  .  .  .  .  .  *
*  .  .  .  *  .  .  .  .  .  .  .  .  *  .  .  .  .  .  *
*  .  .  .  *  .  .  .  .  .  .  .  .  *  .  .  .  .  .  *
*  .  M1 .  D  .  .  .  .  .  .  !1 .  D  .  .  .  .  .  *
*  .  .  .  D  .  .  .  .  .  .  .  .  D  .  .  .  X1 .  *
*  *  *  *  *  *  *  *  *  *  *  *  *  *  *  *  *  *  *  *
