title(Map Editor)
version(1)
author(Penetrode)
25 25
*  *  *  *  *  *  *  *  *  *  *  *  *  *  *  *  *  *  *  *  *  *  *  *  *  
*  .  .  .  .  .  D  .  .  .  .  .  .  .  .  .  .  .  .  .  .  .  .  !0 *  
*  .  !1 .  .  .  D  .  .  .  .  .  .  .  .  .  .  .  .  .  .  .  X1 !1 *  
*  .  .  .  .  *  *  .  .  .  !1 .  .  .  !2 .  .  .  .  M0 .  .  .  .  *  
*  .  .  .  *  .  *  .  .  .  .  .  .  .  .  .  .  .  .  .  .  .  .  .  *  
*  !1 .  *  .  .  *  .  .  .  .  G0 .  .  .  .  .  .  .  .  .  .  .  .  *  
*  .  .  .  .  .  *  .  .  .  .  .  .  .  .  .  .  .  .  .  .  .  .  .  *  
*  .  .  .  !1 .  *  .  .  *  *  *  *  *  M1 .  .  .  .  .  M1 .  .  .  *  
*  .  .  M1 .  .  *  .  .  *  *  *  *  *  .  .  .  .  .  .  .  .  .  M1 *  
*  !0 .  .  .  .  *  .  .  *  *  *  *  *  .  .  .  !1 .  .  .  .  .  .  *  
*  .  .  .  .  .  *  .  .  .  *  *  *  .  .  *  *  *  *  .  .  .  .  .  *  
*  .  M1 .  M1 .  *  .  .  G1 .  .  .  .  *  .  .  .  .  *  .  .  .  M0 *  
*  .  .  .  .  .  *  .  .  .  .  .  .  *  .  .  P2 .  .  .  *  .  .  .  *  
*  D  D  *  *  *  *  *  *  *  D  D  D  *  .  .  .  .  .  !1 *  .  .  .  *  
*  .  .  .  .  .  .  .  .  .  .  .  .  *  .  .  .  P1 .  .  *  .  .  .  *  
*  .  !0 .  .  .  .  .  .  .  .  .  .  *  .  P3 .  .  .  .  *  .  .  .  *  
*  .  G1 .  .  .  .  .  .  .  .  .  .  *  .  .  .  P4 .  !1 *  D  D  D  *  
*  .  .  .  .  .  .  .  M0 .  .  .  M1 *  .  .  .  .  .  .  *  .  .  !2 *  
*  .  .  .  .  M1 .  .  .  .  .  .  .  *  .  G0 .  !0 .  .  *  .  .  .  *  
*  .  .  .  .  .  .  .  .  .  .  .  .  *  .  .  .  .  .  .  *  .  !3 !1 *  
*  .  .  M0 .  .  .  .  .  .  M1 .  .  .  D  .  .  .  .  *  .  !1 !3 !2 *  
*  .  .  .  .  .  .  .  .  .  .  .  .  .  .  *  *  *  *  .  !1 .  .  .  *  
*  !3 !3 .  .  .  .  .  .  .  !2 .  .  .  .  .  .  .  D  .  .  .  !3 .  *  
*  !3 !3 .  M0 .  .  .  .  .  .  .  .  .  !2 .  .  .  D  .  !3 .  .  !2 *  
*  *  *  *  *  *  *  *  *  *  *  *  *  *  *  *  *  *  *  *  *  *  *  *  *  
