title(Map Editor)
version(1)
author(Penetrode)
17 17
*  *  *  *  *  *  *  *  *  *  *  *  *  *  *  *  *  
*  .  .  .  .  !2 *  .  .  .  X1 .  .  .  .  .  *  
*  P1 .  .  P2 .  *  .  M1 .  .  .  .  .  .  .  *  
*  .  .  .  .  .  *  .  .  .  .  .  .  .  .  .  *  
*  .  .  .  .  .  *  .  .  .  G0 .  .  .  .  G1 *  
*  P4 .  .  P3 .  *  .  M1 .  .  .  .  M1 .  .  *  
*  .  .  .  .  .  *  .  .  .  .  .  .  .  .  .  *  
*  .  .  .  .  !0 *  .  .  .  .  .  G0 .  .  .  *  
*  .  .  .  .  !2 *  .  .  .  .  .  .  M1 .  .  *  
*  .  !0 .  .  .  *  *  *  *  *  *  D  D  D  D  *  
*  .  .  .  .  .  *  .  .  !1 .  .  .  .  .  .  *  
*  .  .  .  .  !2 *  .  .  .  .  .  .  .  .  .  *  
*  .  M0 .  .  .  *  .  G1 .  .  .  .  .  .  !3 *  
*  .  .  .  .  .  D  .  .  .  .  .  .  .  !3 !3 *  
*  .  .  M0 .  .  D  .  .  .  .  .  .  .  .  .  *  
*  .  .  .  .  .  D  .  .  !1 .  .  .  !3 .  .  *  
*  *  *  *  *  *  *  *  *  *  *  *  *  *  *  *  *  
