title(Edited Copy)
version(a new one)
author(Penetrode)
25 25
*  *  *  *  *  *  *  *  *  *  *  *  *  *  *  *  *  *  *  *  *  *  *  *  *  
*  .  .  .  .  .  .  M0 *  !1 .  D  .  .  !1 .  .  .  .  .  .  .  .  !1 *  
*  .  .  P1 P2 .  .  .  *  .  .  D  .  .  M1 .  .  .  M0 .  .  .  .  !1 *  
*  !0 .  P4 P3 .  .  .  *  .  .  D  .  .  !0 .  .  .  .  .  .  .  .  .  *  
*  .  .  .  .  .  .  .  *  .  .  *  *  *  *  *  *  *  *  D  D  D  D  *  *  
*  *  *  *  *  .  .  .  *  .  .  *  !2 .  .  .  .  .  .  .  .  .  .  .  *  
*  .  .  .  D  .  .  M0 *  .  .  *  .  .  !2 .  .  .  .  .  .  .  .  .  *  
*  .  .  .  D  .  .  M1 *  .  .  *  .  .  .  .  .  .  .  .  .  .  .  .  *  
*  !0 .  .  D  .  M1 .  *  .  .  *  .  .  .  *  *  *  *  *  *  *  *  *  *  
*  .  .  .  *  *  *  *  *  .  .  *  .  .  .  *  .  .  .  .  .  !3 !3 !3 *  
*  .  .  !1 *  .  !1 .  .  .  *  *  .  .  .  *  .  .  .  !0 .  .  .  .  *  
*  .  .  .  *  .  .  .  .  !0 *  .  M0 M1 M1 *  .  .  .  .  .  .  .  .  *  
*  .  .  .  *  .  .  .  .  .  *  .  !1 !1 M0 *  .  .  .  .  M1 .  .  .  *  
*  .  G0 .  D  .  .  .  .  G1 *  .  !1 !1 .  *  .  .  .  .  .  .  .  M0 *  
*  .  .  .  D  .  .  .  .  .  *  .  !1 !1 .  *  .  .  .  .  .  .  .  .  *  
*  .  .  .  D  .  .  .  .  .  *  .  .  .  D  *  .  .  .  .  .  .  .  .  *  
*  .  .  .  D  .  .  .  .  .  *  .  .  .  D  .  .  .  M0 .  .  M1 .  .  *  
*  .  .  .  *  .  .  !1 .  .  *  .  .  .  D  .  .  .  .  .  .  .  .  .  *  
*  .  .  .  *  *  *  *  *  *  *  .  .  .  D  .  .  .  .  .  .  .  .  .  *  
*  .  .  !1 *  .  .  .  .  !0 *  .  .  .  D  D  *  D  D  D  D  *  D  D  *  
*  .  .  .  D  .  .  .  .  .  *  .  .  .  .  .  *  .  .  .  .  *  .  .  *  
*  .  .  .  D  .  .  M1 .  .  *  .  .  .  .  .  *  !1 .  .  .  *  .  M1 *  
*  .  .  .  D  .  .  .  .  .  *  .  .  .  .  .  *  !1 .  .  .  *  .  .  *  
*  .  .  .  D  .  M0 .  .  !0 *  .  .  !0 .  .  *  .  .  G0 X1 *  !2 !2 *  
*  *  *  *  *  *  *  *  *  *  *  *  *  *  *  *  *  *  *  *  *  *  *  *  *  
