title(Map Editor)
version(1)
author(Penetrode)
24 24
*  *  *  *  *  *  *  *  *  *  *  *  *  *  *  *  *  *  *  *  *  *  *  *  
*  .  P2 .  P3 .  D  .  .  .  .  .  .  .  .  .  .  .  .  .  .  .  X1 *  
*  .  .  .  .  .  D  .  G1 .  .  .  .  .  .  .  .  .  .  .  .  .  .  *  
*  .  .  P4 .  .  *  .  .  .  .  .  .  .  .  .  .  .  .  .  .  .  .  *  
*  .  P1 .  .  .  *  .  .  .  .  .  .  M1 .  .  .  .  .  .  M0 .  .  *  
*  .  .  .  .  .  *  .  .  .  .  .  .  .  .  .  .  .  .  .  .  .  .  *  
*  .  M0 .  .  .  *  *  *  *  *  *  *  .  .  .  M0 .  .  .  .  .  .  *  
*  .  .  .  .  .  .  .  .  .  .  .  *  .  .  .  .  .  .  .  .  .  .  *  
*  .  .  .  .  M1 .  .  .  .  !1 .  *  .  .  .  M1 .  .  M0 .  .  .  *  
*  *  *  D  D  *  *  *  .  .  .  .  *  .  .  .  .  .  !1 .  .  .  .  *  
*  .  .  .  .  .  .  *  .  .  !1 .  *  .  .  .  .  .  .  .  .  !2 .  *  
*  .  !0 .  G1 .  .  *  .  .  .  .  *  .  !2 .  .  .  !2 .  .  .  .  *  
*  .  .  .  .  .  .  *  .  .  .  .  *  .  .  .  .  .  .  .  M1 .  .  *  
*  .  G0 .  .  .  .  *  .  .  .  !1 *  .  .  .  .  .  .  .  .  !1 .  *  
*  .  .  .  .  .  .  *  .  !1 .  .  *  *  *  *  *  *  *  .  .  .  .  *  
*  .  .  .  .  .  .  *  .  .  .  .  .  .  .  .  .  .  *  .  .  !3 .  *  
*  .  .  .  M1 .  .  *  .  .  .  .  .  .  .  .  .  .  *  .  !1 .  .  *  
*  .  !0 .  .  .  .  *  .  .  .  .  G0 .  .  .  .  .  *  .  .  .  .  *  
*  .  .  .  .  .  .  *  .  .  .  .  .  .  .  .  .  .  *  .  M1 .  !3 *  
*  .  .  .  .  .  .  *  *  *  *  *  *  *  *  *  .  .  *  !3 .  .  .  *  
*  .  .  M1 .  .  .  .  .  .  .  .  .  .  .  .  .  .  *  .  .  !1 .  *  
*  !1 .  .  .  .  .  M1 .  .  .  M1 .  .  .  .  .  .  *  .  .  .  .  *  
*  .  .  !1 .  .  .  .  M0 .  .  .  .  .  .  .  .  .  *  .  .  .  .  *  
*  *  *  *  *  *  *  *  *  *  *  *  *  *  *  *  *  *  *  *  *  *  *  *  
