title(Map Editor)
version(1)
author(Penetrode)
21 21
*  *  *  *  *  *  *  *  *  *  *  *  *  *  *  *  *  *  *  *  *  
*  .  !0 !3 .  M1 .  .  .  .  .  .  .  .  .  .  .  .  .  .  *  
*  .  !3 M1 .  .  .  G1 .  .  .  .  !2 .  M0 .  .  .  .  .  *  
*  *  *  *  *  *  *  *  *  *  *  *  *  *  *  *  *  .  .  .  *  
*  .  .  .  .  .  .  .  .  .  .  .  .  D  .  !1 *  .  M0 .  *  
*  .  .  G0 .  .  .  .  .  .  .  M1 .  D  .  .  *  .  .  .  *  
*  .  .  .  .  .  .  .  .  M0 .  .  .  D  .  X1 *  .  .  .  *  
*  .  .  .  .  *  *  *  *  *  *  *  *  *  *  *  *  .  .  .  *  
*  D  D  D  *  *  .  .  .  .  .  .  .  M1 .  .  .  .  .  .  *  
*  .  .  .  .  *  .  .  M1 .  .  .  .  .  .  .  .  .  .  .  *  
*  .  .  .  .  *  .  .  .  *  *  *  *  *  *  *  *  .  .  .  *  
*  .  .  .  .  *  .  .  .  .  .  .  !1 .  .  .  *  .  .  .  *  
*  .  M0 .  .  *  .  M1 .  .  !1 .  .  !3 .  .  *  .  .  .  *  
*  .  .  .  .  *  *  *  *  *  *  *  *  .  .  !3 *  .  .  .  *  
*  .  .  .  .  .  .  .  .  .  .  .  *  !3 .  .  *  .  .  .  *  
*  .  .  .  M1 .  .  !2 G1 .  .  .  *  .  .  *  *  *  D  D  *  
*  .  .  .  .  .  .  .  .  *  .  .  *  !0 .  *  !0 .  .  .  *  
*  .  .  .  M1 .  .  .  .  *  .  .  *  *  *  *  .  P3 .  P2 *  
*  !2 .  .  .  M1 .  .  .  *  .  .  G0 .  .  D  .  .  .  .  *  
*  !0 .  .  .  !2 .  .  .  *  .  .  .  .  .  D  .  P4 .  P1 *  
*  *  *  *  *  *  *  *  *  *  *  *  *  *  *  *  *  *  *  *  *  
