title(Level 2)
version(1)
author(Scott)
30 30
*  *  *  *  *  *  *  *  *  *  *  *  *  *  *  *  *  *  *  *  *  *  *  *  *  *  *  *  *  *
*  !1 .  .  .  .  !1 .  .  D  .  .  .  .  .  .  .  .  D  .  !0 . G0  *  .  .  *  X1 .  *
*  .  .  .  .  .  .  .  .  D  .  .  .  .  .  .  .  .  D  .  .  .  .  *  .  .  *  .  .  *
*  .  .  .  .  .  .  .  .  D  .  .  .  .  .  .  !0 .  *  .  !2 .  .  *  .  .  *  M1 .  *
*  .  .  .  .  .  .  G0 .  *  .  .  .  .  .  .  .  .  *  .  .  .  !1 *  .  .  *  D  D  *
*  .  .  .  .  .  .  .  .  *  .  .  *  *  *  *  *  *  *  *  *  *  *  *  .  .  .  .  .  *
*  .  .  .  .  .  .  .  .  *  .  .  .  !0 *  !3 !3 .  D  .  .  .  !1 *  .  G0 .  .  .  *
*  .  .  .  .  .  .  .  .  *  .  .  .  .  *  !3 !3 .  D  .  .  .  .  *  .  .  .  .  .  *
*  !1 .  .  .  .  .  .  .  *  .  .  .  .  *  !3 !1 .  *  .  .  .  .  *  .  .  .  .  .  *
*  .  .  M1 .  .  M1 .  .  *  .  .  .  .  *  !3 !3 .  *  .  .  .  .  *  D  D  D  *  *  *
*  .  .  .  .  .  .  .  .  *  .  .  .  .  *  !3 .  .  *  .  .  .  .  *  .  .  .  .  .  *
*  .  .  .  .  .  .  .  .  *  .  .  .  .  *  !3 !1 .  *  .  .  .  .  *  .  .  .  .  .  *
*  .  .  .  .  .  .  .  !0 *  .  .  .  .  *  !0 .  .  *  .  .  M1 .  *  !1 .  .  .  .  *
*  .  .  *  *  *  *  *  *  *  *  .  .  .  *  *  *  *  *  .  .  .  .  *  !1 .  M1 .  .  *
*  M1 .  .  .  .  .  *  .  .  .  .  .  .  .  .  .  .  *  .  .  .  .  *  *  .  .  .  .  *
*  .  .  .  .  G0  . *  .  .  .  .  .  .  .  .  .  .  *  .  .  .  M1 .  *  .  .  .  .  *
*  .  .  .  .  .  .  *  .  M1 .  .  .  .  .  .  .  .  *  .  .  *  .  .  *  .  .  .  M1 *
*  !0 .  .  .  .  .  *  .  .  .  .  .  .  .  .  .  !1 *  .  .  *  .  .  *  .  .  .  .  *
*  .  .  .  .  .  .  *  .  .  M1 .  .  .  .  .  M1 !2 *  M1 .  *  .  .  *  .  .  .  .  *
*  .  .  .  .  .  .  *  .  .  .  .  .  .  .  .  .  .  *  .  .  *  .  .  *  .  .  .  .  *
*  .  .  .  .  .  .  *  .  .  .  .  M1 .  .  M1 .  .  *  .  .  *  .  M1 *  .  M1 .  .  *
*  *  *  *  .  .  .  *  !0 .  .  .  .  .  .  .  .  .  *  .  .  *  .  .  *  .  .  .  .  *
*  P2 .  *  *  D  D  *  *  *  *  *  *  .  .  .  .  .  *  .  .  *  .  .  *  .  .  .  .  *
*  .  .  .  .  .  .  *  !1 .  !1 .  D  .  .  .  .  .  *  .  !1 *  .  .  D  .  .  .  .  *
*  P3 .  .  .  .  .  *  .  .  .  !1 D  .  .  M1 .  .  *  .  .  *  !1 .  D  .  .  M1 .  *
*  .  .  .  .  .  .  *  !1 !0 .  .  D  .  .  .  .  .  *  .  .  *  .  .  D  .  .  .  .  *
*  .  P1 .  P4 .  .  *  .  !1 .  .  D  .  .  .  .  .  *  .  .  *  .  .  *  M1 .  .  .  *
*  .  .  .  .  .  !1 *  !0 .  !1 .  *  .  .  .  M1 .  D  .  .  *  .  .  *  .  .  .  .  *
*  !0 .  .  .  .  .  *  .  !2 !1 .  *  .  .  .  .  .  D  .  .  *  .  !1 *  .  .  !1 !0 *
*  *  *  *  *  *  *  *  *  *  *  *  *  *  *  *  *  *  *  *  *  *  *  *  *  *  *  *  *  *
