title(Map Editor)
version(1)
author(Penetrode)
23 23
*  *  *  *  *  *  *  *  *  *  *  *  *  *  *  *  *  *  *  *  *  *  *  
*  .  !2 .  D  .  .  .  .  M1 .  .  .  .  .  .  .  *  .  .  P3 P2 *  
*  !2 !2 .  D  .  .  .  M0 .  .  .  .  .  .  .  .  D  .  .  P1 P4 *  
*  .  .  .  *  .  .  M1 .  .  .  .  .  .  .  .  .  D  .  .  .  .  *  
*  !0 .  .  *  .  M0 .  .  .  .  .  .  .  .  .  .  *  .  .  .  .  *  
*  *  *  *  *  M1 .  .  *  *  *  *  *  *  *  *  *  *  .  .  !0 .  *  
*  .  .  .  .  !3 .  .  .  .  .  .  .  .  .  .  .  *  M1 .  .  .  *  
*  .  .  .  .  .  .  .  .  .  G0 .  .  .  .  G1 .  *  .  .  .  .  *  
*  .  .  .  .  .  .  .  .  .  .  .  .  .  .  .  .  *  .  M1 .  M1 *  
*  .  .  .  .  .  .  .  .  .  .  .  .  .  .  .  .  *  .  .  .  .  *  
*  .  .  .  .  .  .  *  *  *  D  D  *  *  *  *  *  *  *  *  D  D  *  
*  !1 .  G0 .  .  .  *  .  .  .  .  .  !3 *  .  .  .  .  .  .  .  *  
*  .  .  .  .  .  .  *  .  !3 !2 !3 !1 !1 *  .  .  .  .  .  .  .  *  
*  !3 .  .  .  .  .  *  *  *  *  *  *  *  *  .  .  .  .  .  G1 .  *  
*  *  *  *  .  .  .  .  .  .  .  .  .  .  *  .  !0 .  .  .  .  .  *  
*  X1 .  *  !0 .  .  .  .  M1 .  .  M1 .  *  .  .  .  .  .  .  .  *  
*  .  .  *  *  *  *  *  .  .  .  .  .  .  *  .  .  .  .  .  .  .  *  
*  .  .  .  .  !2 .  *  .  .  M1 .  M1 .  *  .  .  .  .  .  .  .  *  
*  .  .  M1 .  .  M1 *  *  *  *  D  D  *  *  .  G0 .  .  .  .  .  *  
*  .  .  .  .  .  .  .  .  .  .  .  .  .  .  .  .  .  .  .  .  .  *  
*  .  .  .  .  .  .  .  .  .  !2 .  .  .  .  .  .  .  .  .  G1 .  *  
*  .  .  !1 .  .  !1 .  .  .  .  .  .  .  .  .  .  .  .  .  .  .  *  
*  *  *  *  *  *  *  *  *  *  *  *  *  *  *  *  *  *  *  *  *  *  *  
