title(Map Editor)
version(1)
author(Penetrode)
22 22
*  *  *  *  *  *  *  *  *  *  *  *  *  *  *  *  *  *  *  *  *  *  
*  .  .  .  .  .  .  !2 .  .  .  D  .  .  .  .  .  .  !2 .  .  *  
*  .  .  .  .  .  .  .  .  .  .  D  .  .  .  .  .  .  .  .  .  *  
*  .  P4 .  .  .  .  .  .  .  .  D  .  .  .  .  .  M0 .  .  M1 *  
*  .  .  .  .  .  .  M1 .  .  .  D  .  .  .  .  .  .  .  .  .  *  
*  .  P3 .  .  .  .  .  .  .  .  *  .  .  .  .  .  .  .  .  .  *  
*  .  .  .  .  .  .  .  .  .  .  *  .  .  M1 .  .  M1 .  .  !2 *  
*  .  P2 .  .  .  .  .  .  G1 .  *  .  .  .  .  .  .  .  .  .  *  
*  .  .  .  .  .  .  .  .  .  .  *  .  .  .  .  .  .  .  .  .  *  
*  .  P1 .  .  .  .  .  .  .  !0 *  .  .  .  .  .  .  .  .  .  *  
*  *  *  *  *  *  *  *  *  *  *  *  .  .  M0 .  .  M1 .  .  .  *  
*  .  X1 .  .  !1 .  .  .  !1 .  *  !0 .  .  .  .  .  .  !2 .  *  
*  .  .  M1 .  M0 .  .  .  .  .  *  .  .  .  .  .  .  .  .  .  *  
*  .  .  .  .  .  !1 .  .  !1 .  *  .  .  .  .  .  M1 .  .  .  *  
*  .  .  .  .  .  .  .  .  .  .  *  .  .  .  .  .  .  .  M0 .  *  
*  .  .  .  .  .  .  .  .  .  .  *  .  .  .  .  .  .  .  .  .  *  
*  D  D  D  D  D  D  D  D  D  D  D  D  D  D  D  D  D  D  D  D  *  
*  .  .  .  .  .  .  .  .  .  .  .  .  .  .  .  .  .  .  .  .  *  
*  M1 .  .  .  M1 .  .  .  M1 .  .  .  M1 .  .  .  .  .  M1 .  *  
*  .  .  .  .  G0 .  .  .  G1 .  .  .  G0 .  .  .  G1 .  .  .  *  
*  .  .  .  .  .  .  .  .  .  .  .  .  .  .  M1 .  .  .  M0 .  *  
*  *  *  *  *  *  *  *  *  *  *  *  *  *  *  *  *  *  *  *  *  *  
