title(Map Editor)
version(1)
author(Penetrode)
23 23
*  *  *  *  *  *  *  *  *  *  *  *  *  *  *  *  *  *  *  *  *  *  *  
*  P1 P2 .  .  .  .  *  .  .  .  .  .  .  .  D  .  .  .  .  .  X1 *  
*  P4 P3 .  .  .  .  *  .  .  .  .  M1 .  .  D  .  .  .  !3 .  .  *  
*  *  *  *  .  .  .  *  *  *  *  .  .  .  .  D  .  .  G0 .  .  .  *  
*  .  !0 *  .  .  .  .  .  .  *  .  M0 .  .  *  *  *  .  .  !3 .  *  
*  .  .  *  *  *  .  M0 .  .  *  *  *  .  .  .  .  *  .  .  .  .  *  
*  .  .  .  .  *  .  .  .  .  .  .  *  .  .  .  .  *  *  *  .  .  *  
*  .  .  .  .  *  *  *  .  M1 .  .  *  *  *  M1 .  .  .  *  !3 .  *  
*  .  .  .  .  .  .  *  .  .  .  .  M0 .  *  .  .  .  M1 *  *  *  *  
*  .  G1 .  .  M0 .  *  *  *  !0 .  .  .  *  *  *  .  .  .  .  !2 *  
*  *  *  D  D  .  .  .  .  *  .  .  .  .  .  .  *  .  .  .  .  .  *  
*  .  .  .  D  .  .  .  M1 *  *  *  M0 .  .  M1 *  *  *  .  G1 .  *  
*  .  .  .  D  D  *  .  .  .  .  *  .  .  .  .  .  .  *  .  .  .  *  
*  .  .  .  .  .  *  .  .  .  .  *  *  *  .  .  .  .  *  D  D  D  *  
*  .  M1 .  .  .  *  *  *  .  .  .  .  *  .  M1 .  .  M0 .  .  .  *  
*  .  .  .  .  .  .  .  *  .  M1 .  .  *  *  *  .  .  .  .  .  .  *  
*  *  *  *  .  !1 M0 .  *  *  *  .  .  .  .  *  .  .  .  .  .  .  *  
*  .  !1 *  .  .  .  .  .  .  *  .  .  M0 .  *  *  *  M1 .  .  M1 *  
*  .  !1 *  *  *  .  .  .  .  *  *  *  .  .  .  .  *  .  .  .  .  *  
*  .  .  .  .  *  *  !1 .  .  .  .  *  .  .  .  .  *  *  *  .  .  *  
*  .  .  .  .  .  D  .  .  .  .  .  *  *  *  .  .  .  .  D  .  .  *  
*  X1 .  .  .  .  D  .  .  M1 .  !1 .  !2 *  .  .  .  .  D  .  !0 *  
*  *  *  *  *  *  *  *  *  *  *  *  *  *  *  *  *  *  *  *  *  *  *  
